Mm^Xm, Mm^Xm, Mm^Xm, Mm^Xm, Mm^Xm, Mm^Xm, Mm^Xm, Mm^Xm, Mm^Xm, Mm^Xm, Mm^Xm, Mm, Mm, Mm, Mm, Gg, Gg, Gg, Gg, Gg, Gg, Mm, Mm, Mm^Xm, Mm^Xm, Mm^Xm, Mm^Xm, Mm^Xm, Mm^Xm, Mm, Wo, Wo, Ai, Ai, Ms, Ms, Ms
Mm^Xm, Mm^Xm, Mm^Xm, Mm^Xm, Mm^Xm, Mm^Xm, Mm^Xm, Mm^Xm, Mm^Xm, Mm^Xm, Mm^Xm, Mm, Mm, Mm, Mm, Gg, Gg, Gg, Gg, Gg, Gg, Mm, Mm, Mm^Xm, Mm^Xm, Mm^Xm, Mm^Xm, Mm^Xm, Mm^Xm, Mm, Wo, Wo, Ai, Ai, Ms, Ms, Ms
Mm^Xm, Mm^Xm, Mm^Xm, Mm^Xm, Mm^Xm, Mm^Xm, Mm, Mm^Xm, Mm^Xm, Mm^Xm, Mm, Mm^Xm, Mm, Mm, Mm, Gg^Efm, Gg^Efm, Gg, Gg, Gg, Gg, Mm, Mm, Mm^Xm, Mm^Xm, Mm^Xm, Mm^Xm, Mm^Xm, Mm^Xm, Mm, Wo, Ai, Ai, Ha^Vhha, Ms, Ms, Ms
Mm^Xm, Mm^Xm, Mm^Xm, Mm^Xm, Mm, Mm, Mm, Mm, Mm, Mm, Mm, Mm, Mm, Mm, Hh, Hh, Gg, Gg, Gs^Fds, Gs^Fds, Gs^Fms, Mm, Mm, Mm, Mm, Mm, Mm, Mm^Xm, Mm, Mm, Wo, Ms, Ms, Ms, Mm^Xm, Mm^Xm, Mm^Xm
Mm^Xm, Mm^Xm, Mm, Mm, Mm, Mm, Gs^Fds, Gs^Fms, Hh, Mm, Mm, Mm, Hh, Hh, Hh^Vo, Gg, Gg, Gg^Vo, Gg, Gs^Fms, Chr, Gs^Fp, Gs^Fp, Mm, Mm, Mm, Mm, Mm, Wo, Wo, Mm, Mm, Mm^Xm, Mm^Xm, Mm^Xm, Mm^Xm, Mm^Xm
Mm, Mm, Mm, Mm, Mm, Mm, Gs^Fds, Gs^Fds, Hh^Vo, Hh, Hh, Hh, Hh, Hh, Gg, Gs^Fms, Gg, Gg, Gg, Chr, 3 Koa, Cha, Aa^Fpa, Aa^Fpa, Mm, Mm, Mm^Xm, Mm, Wo, Mm, Mm, Mm^Xm, Mm, Mm, Mm^Xm, Mm^Xm, Mm^Xm
Mm, Mm, Mm, Mm, Mm, Mm, Hh, Gs^Fms, Hh, Hh, Gs^Fds, Hh, Gs^Fds, Gg, Gs^Fds, Gs^Fds, Gs^Fms, Gg, Aa, Cha, Cha, Cha, Aa^Fpa, Aa^Fpa, Mm, Mm^Xm, Wo, Wo, Mm^Xm, Mm, Mm, Mm, Hh, Mm, Mm, Mm^Xm, Mm^Xm
Mm^Xm, Mm^Xm, Mm, Hh^Vo, Hh, Hh, Hh, Hh, Gs^Fms, Hh, Hh, Gs^Fds, Gs^Fds, Gs^Fds, Gs^Fds, Gs^Fms, Gg, Gg, Aa, Aa, Aa^Fpa, Aa^Fpa, Aa^Fpa, Aa^Fpa, Mm^Xm, Mm, Wo, Mm^Xm, Mm, Mm, Hh, Hh, Hh, Mm, Mm, Mm, Mm
Mm^Xm, Mm^Xm, Mm, Hh, Hh, Gs^Fms, Gs^Fms, Hh, Gs^Fds, Gs^Fms, Gg, Gs^Fms, Gs^Fms, Gg, Gs^Fms, Gs^Fms, Aa^Fpa, Ha, Mm, Mm, Mm, Aa^Fpa, Mm, Mm^Xm, Wo, Wo, Mm, Mm, Hh, Hh, Hh, Gs^Fp, Gs^Fp, Hh, Hh, Mm, Mm
Mm^Xm, Mm^Xm, Mm, Hh, Hh, Hh, Gg, Gs^Fds, Gs^Fds, Gs^Fms, Gs^Fms, Gg, Aa^Fpa, Gs^Fms, Aa^Fpa, Aa^Fpa, Ha, Aa^Voa, Mm, Mm, Mm, Mm, Wo, Wo, Mm, Mm, Mm, Mm, Hh, Hh, Hh, Gs^Fp, Aa^Vca, Gs^Fp, Ha, Mm, Ms
Mm^Xm, Mm^Xm, Mm, Hh, Gs^Fms, Gs^Fms, Gs^Fms, Gs^Fds, Gs^Fds, Gs^Fms, Gs^Fms, Aa, Aa^Fpa, Ha, Aa^Fpa, Aa^Fpa, Ha, Mm, Mm, Mm, Wo, Wo, Mm, Mm, Mm, Mm, Gs^Fp, Gs^Fp, Gs^Fp, Gs^Fp, Gs^Fp, Aa, Aa^Fpa, Aa^Fpa, Aa^Fpa, Ms, Ms
Mm^Xm, Mm^Xm, Mm, Hh, Gg, Gg, Gs^Fms, Gs^Fms, Gs^Fms, Gs^Fms, Aa^Fpa, Aa^Fpa, Ha, Aa^Fpa, Mm, Aa^Voa, Mm, Mm, Wo, Wo, Mm, Mm, Mm, Mm, Gs^Fp, Gs^Fp, Gs^Fp, Gs^Fp, Gs^Fp, Gs^Fp, Gg, Aa^Fpa, Aa^Fpa, Aa^Fpa, Mm, Ms^Xm, Ms^Xm
Mm^Xm, Mm^Xm, Mm, Mm, Mm, Gg, Gg^Efm, Gg, Gg, Ha, Ha, Ha, Ha, Mm, Mm, Mm, Mm, Wo, Mm, Mm, Mm, Mm, Mm, Mm, Gg^Vc, Gs^Fp, Aa, Gs^Fp, Gs^Fp, Gs^Fp, Gg, Aa^Fpa, Aa^Fpa, Mm, Mm, Mm^Xm, Mm^Xm
Mm^Xm, Mm^Xm, Mm, Mm, Mm, Hh, Gg, Gg, Ha, Ha, Ha, Ha, Mm, Mm, Mm, Mm, Wo, Wo, Mm, Mm, Mm, Gs^Fp, Gs^Fp, Gg, Gs^Fp, Gs^Fp, Gs^Fp, Gs^Fp, Gs^Fp, Gg, Gg, Gg, Aa^Fpa, Mm, Mm^Xm, Mm^Xm, Mm^Xm
Mm^Xm, Mm^Xm, Hh, Mm, Mm, Hh, Gg, Gg, Ha^Voa, Ha, Mm, Mm, Mm, Mm, Wo, Wo, Mm, Mm, Mm, Mm, Mm, Gs^Fp, Gs^Fp, Gg, Gg, Gs^Fp, Gg, Gs^Fp, Aa, Gs^Fp, Gg, Gg, Mm, Mm, Mm^Xm, Mm^Xm, Mm^Xm
Mm, Mm, Hh, Gs^Fms, Gs^Fds, Gg, Gg, Gg, Mm, Mm, Mm, Mm, Mm, Wo, Mm, Mm, Mm, Mm, Mm, Mm, Mm, Gs^Fp, Gg, Gg, Gg, Gg, Gg, Gs^Fp, Gs^Fp, Gs^Fp, Gg, Gg, Mm, Mm, Mm, Mm^Xm, Mm^Xm
Mm, Mm, Hh^Vo, Gs^Fms, Gs^Fds, Gs^Fds, Gs^Fms, Gg, Mm, Mm, Mm, Mm, Wo, Wo, Mm, Mm, Mm, Mm, Hh, Mm, Gg, Gg, Gg, Gg, Gg, Gg, Gg, Gg, Gg, Gg, Gg, Gg, Aa^Fpa, Mm, Mm, Mm, Mm
Mm, Mm, Gs^Fds, Gs^Fms, Gg, Gs^Fms, Gs^Fms, Gg^Vo, Aa, Mm, Mm, Wo, Mm, Mm, Gg^Vc, Mm, Hh, Hh, Hh, Hh, Hh, Gg, Aa, Aa, Aa, Gg, Gg, Gg, Gg, Gg, Gg, Aa, Aa, Aa^Fpa, Mm, Mm, Mm
Mm, Mm, Gs^Fds, Gg, Hh, Gs^Fds, Gs^Fms, Gs^Fms, Ai, Ai, Ai, Wo, Ai, Ai, Ai, Gs^Fms, Gg, Hh, Hh, Hh, Hh, Aa, Mm, Aa, Aa^Fpa, Aa, Aa^Fpa, Gg, Gg, Gg, Gg, Gg, Aa, Hh, Hh, Mm, Mm
Mm^Xm, Mm^Xm, Hh, Hh, Gg, Gg, Gg, Gg, Ai, Ai, Ai, Ai, Ai, Ai, Ai, Gs^Fmw, Gs^Fms, Gg, Hh, Hh, Ha, Mm, Mm, Mm, Aa^Fpa, Aa^Fpa, Aa^Fpa, Gg, Gg, Gg, Gg, Gg, Hh, Hh, Mm, Mm, Mm
Mm^Xm, Mm^Xm, Mm, Hh, Gg, Gg, Gg, Gg, Ai, Ai, Ai, Wo, Wo, Ai, Ai, Ai, Gs^Fmw, Gg, Hh, Ha, Mm, Mm, Wo, Mm^Xm, Mm^Xm, Aa^Vca, Mm^Xm, Mm, Mm, Gg, Gg, Gg, Hh, Hh, Mm, Mm, Mm
Mm, Mm, Mm, Hh, Gg, Gg, Gg, Ai, Ai, Ai, Ai, Ai, Ai, Ai, Ai, Ai, Gs^Fms, Gg, Ha, Ha, Mm, Mm^Xm, Wo, Wo, Wo, Mm, Mm^Xm, Mm^Xm, Mm^Xm, Hh^Vhh, Gg, Gg, Gg, Hh, Mm, Mm, Mm
Mm, Mm, Mm^Xm, Hh, Gg^Vo, Gg, Gg, Ai, Ai, Ai, Ai, Ai, Ai, Ai, Ai, Ai, Gg^Vo, Gg, Aa, Ha, Mm, Mm^Xm, Mm^Xm, Wo, Wo, Mm, Mm, Mm, Mm, Mm, Gg, Gg, Gg, Mm, Mm, Mm, Mm
Mm, Mm, Mm, Hh, Hh, Gg, Gg, Gg, Gg, Ai, Ai, Ai, Ai, Ai, Ai, Ai, Ww^Bw/, Aa, Aa, Ha, Ha^Vhha, Mm^Xm, Mm^Xm, Mm^Xm, Mm, Wo, Mm, Mm, Mm, Mm, Gg, Gg, Gg, Mm, Mm, Mm, Mm
Mm, Mm, Mm, Mm, Hh, Gg, Gg, Gg, Gs^Fmw, Gg, Gs^Fms, Ai, Gg, Ai, Gg, Ww^Bw/, Wo, Wo, Ai, Ha, Ha, Mm, Mm, Mm, Wo, Wo, Mm, Hh, Hh, Hh, Gg, Gg, Gg, Mm, Mm, Mm, Mm
Mm^Xm, Mm^Xm, Mm, Mm, Hh, Hh, Gs^Fmw, Gg^Efm, Gs^Fmw, Gs^Fmw, Gs^Fmw, Gs^Fmw, Gs^Fmw, Gg^Vo, Gs^Fmw, Gs^Fds, Gs^Fmw, Wo, Wo, Ai, Wo, Ha, Wo, Wo, Mm, Mm, Mm, Mm, Gs^Fp, Hh, Gs^Fms, Gg, Gg, Gg, Hh, Mm, Mm
Mm^Xm, Mm^Xm, Ms, Mm, Ha, Gs^Fp, Aa^Fpa, Gs^Fmw, Aa^Fpa, Gs^Fmw, Gs^Fmw, Aa, Gs^Fmw, Gg, Gs^Fds, Gg, Gs^Fds, Gs^Fms, Gs^Fmw, Wo, Ai, Wo, Wo, Ha, Ms, Ms^Xm, Ms, Aa^Fpa, Gs^Fp, Gs^Fms, Hh, Gg, Ce, Gg, Gg, Mm, Mm
Ms, Ms, Ms, Ha, Ha, Ha, Ha, Gs^Fp, Ha^Voa, Gs^Fp, Aa^Fpa, Gs^Fp, Gs^Fp, Gs^Fmw, Gs^Fmw, Gs^Fmw, Gg, Gg, Gg, Gs^Fms, Wo, Wo, Ai, Ha, Ms, Ms^Xm, Ms^Xm, Mm, Hh, Gs^Fds, Gs^Fds, Ce, 1 Ke, Ce, Gg, Gg, Gg
Ms, Ms, Ms, Aa^Voa, Ha, Ha, Ha, Ha, Ha, Aa^Fpa, Ha, Ha^Voa, Ha, Aa^Fpa, Gs^Fp, Aa, Gg^Vo, Gg, Gs^Fms, Gs^Fds, Gg, Wo, Wo, Ha, Ms, Ms^Xm, Ms^Xm, Mm, Mm, Hh, Gg, Ce, Ce, Ce, Gg, Gg, Gg
Ms, Ms, Ms^Xm, Ms, Ms, Ha, Ha, Ha, Ha, Ha, Ha, Ha, Ha, Ha, Ha, Hh, Hh, Gs^Fds, Gs^Fms, Gs^Fds, Gg, Gg, Wo, Ha, Ms, Ms^Xm, Mm^Xm, Mm, Mm, Hh, Gs^Fds, Gg, Gg, Gg, Hh, Gg, Gg
Mm^Xm, Ms^Xm, Ms^Xm, Ms, Ms, Ms, Ms, Ha, Ms, Ha, Ha, Ha, Mm, Mm, Mm, Hh, Hh, Hh, Hh, Gs^Fds, Gs^Fms, Gg, Wo, Ha, Ha, Mm, Mm, Mm^Xm, Mm^Xm, Mm, Hh, Gg, Gg, Gg, Mm, Mm, Mm
Mm, Mm, Mm^Xm, Ms, Mm^Xm, Ms, Ms, Ms, Ms, Ms, Mm, Mm, Mm, Mm, Mm, Hh, Hh, Gs^Fp, Hh, Aa, Gs^Fds, Gg, Gg, Wo, Wo, Mm, Mm, Mm, Mm^Xm, Mm, Mm, Gg, Ha^Vhha, Gg, Ha, Mm, Ms
Mm, Mm, Mm, Mm^Xm, Mm^Xm, Mm^Xm, Mm^Xm, Ms, Mm, Mm^Xm, Mm, Mm, Mm, Mm, Mm, Hh, Hh, Hh, Gs^Fds, Gs^Fms, Co, Co, Co, Gs^Fds, Gs^Fds, Wo, Mm, Mm, Mm, Mm, Mm, Ha, Ha, Ha, Ha, Ms, Ms
Mm^Xm, Mm^Xm, Mm^Xm, Mm^Xm, Mm^Xm, Mm^Xm, Mm^Xm, Mm^Xm, Mm^Xm, Mm, Mm, Mm, Mm, Mm, Hh^Vo, Hh, Gs^Fms, Hh, Gs^Fms, Gs^Fds, Co, 2 Ko, Co, Gs^Fds, Gs^Fds, Wo, Mm, Mm^Xm, Mm^Xm, Ms, Ms, Ms, Ms, Ha, Ha, Ms, Ms
Mm^Xm, Mm^Xm, Mm^Xm, Mm, Mm^Xm, Mm^Xm, Mm^Xm, Mm^Xm, Mm, Mm^Xm, Mm^Xm, Mm, Mm, Mm, Hh, Hh, Hh, Gs^Fms, Hh, Gs^Fds, Gs^Fds, Co, Gg^Vo, Gs^Fds, Gs^Fds, Wo, Mm, Mm, Mm, Mm^Xm, Mm^Xm, Ms, Ms, Ms, Mm, Ms, Ms
Mm^Xm, Mm^Xm, Mm^Xm, Mm^Xm, Mm, Mm^Xm, Mm^Xm, Mm^Xm, Mm^Xm, Mm^Xm, Mm^Xm, Mm, Mm, Mm, Mm, Hh^Vo, Hh, Hh, Hh, Hh, Hh, Gs^Fds, Gs^Fds, Gs^Fds, Gs^Fds, Wo, Mm, Mm, Mm, Mm, Mm, Mm, Mm, Mm, Mm, Mm, Mm
Mm^Xm, Mm^Xm, Mm^Xm, Mm^Xm, Mm, Mm^Xm, Mm^Xm, Mm^Xm, Mm^Xm, Mm^Xm, Mm^Xm, Mm, Mm, Mm, Mm, Hh, Hh, Hh, Hh, Hh, Hh, Gs^Fds, Gs^Fds, Gs^Fds, Gs^Fds, Wo, Mm, Mm, Mm, Mm, Mm, Mm, Mm, Mm, Mm, Mm, Mm
