Mm, Mm, Mm, Mm, Mm, Mm, Mm, Mm, Mm, Mm, Mm, Mm, Mm, Mm, Mm, Mm, Mm, Mm, Hh, Gs^Fp, Gs^Fp, Gs^Fp, Gs^Fp, Gs^Fp, Gs^Fp, Gs^Fp, Gs^Fp, Gs^Fp, Gs^Fp, Gs^Fp, Gs^Fp, Gg, Gs^Fp, Gg, Gg, Gg, Gg, Ww, Gs^Fp, Gs^Fp, Gs^Fp, Gs^Fp, Gs^Fp, Gs^Fp, Gs^Fp, Gs^Fp, Gs^Fp, Gs^Fp, Gs^Fp, Gs^Fp, Gs^Fp, Gs^Fp
Mm, Mm, Mm, Mm, Mm, Mm, Mm, Mm, Mm, Mm, Mm, Mm, Mm, Mm, Mm, Mm, Mm, Mm, Hh, Gs^Fp, Gs^Fp, Gs^Fp, Gs^Fp, Gs^Fp, Gs^Fp, Gs^Fp, Gs^Fp, Gs^Fp, Gs^Fp, Gs^Fms, Re^Gvs, Re^Gvs, Re^Gvs, Gg, Re^Gvs, Gs^Vh, Gg, Ww, Gs^Fp, Gs^Fp, Gs^Fp, Gs^Fp, Gs^Fp, Gs^Fp, Gs^Fp, Gs^Fp, Gs^Fp, Gs^Fp, Gs^Fp, Gs^Fp, Gs^Fp, Gs^Fp
Mm, Mm, Mm, Mm, Mm, Mm, Mm, Mm, Mm, Mm, Mm, Mm, Hh, Hh, Hh, Hh, Hh, Hh, Gs^Fp, Gs^Fp, Gs^Fp, Gs^Fp, Gs^Fp, Gs^Fp, Gs^Fp, Gg, Gs^Fp, Gs^Fms, Gs^Fms, Gs^Fms, Gg, Re^Gvs, Re^Gvs, Re^Gvs, Re^Gvs, Re^Gvs, Gg, Ww, Ww, Gs^Fp, Gg, Gs^Fp, Gs^Fp, Gs^Fp, Gs^Fp, Gs^Fp, Gs^Fp, Hh, Gs^Fp, Gs^Fp, Gs^Fp, Gs^Fp
Mm, Mm, Mm, Mm, Xoc, Xoc, Xoc, Mm, Mm, Mm, Hh, Ch, Gg, Hh, Hh, Hh, Re^Gvs, Gs^Fp, Re^Gvs, Gs^Fp, Gs^Fp, Gg, Gs^Fp, Gg, Gs^Fp, Gs^Fms, Gs^Fms, Gs^Fp, Gs^Fms, Gs^Fms, Gs^Fms, Gs^Fms, Gs^Fms, Re^Gvs, Gg, Re^Gvs, Gs^Fp, Gs^Fp, Gs^Fp, Ww, Ww, Ww, Ww, Gs^Fp, Gs^Fp, Gg, Gs^Fp, Hh, Hh, Hh, Gs^Fp, Gs^Fp
Mm, Mm, Xoc, Xoc, Xoc, Xoc, Xoc^Efs, Xoc, Xoc, Mm, Hh, Hh, Gg, Ce, Ce, Gg, Gg, Re^Gvs, Gg, Re^Gvs, Gg, Gs^Fp, Gs^Fp, Gs^Fms, Gs^Fms, Gs^Fms, Gg, Gs^Fms, Gg, Gs^Vh, Gg, Gs^Fms, Gg, Gs^Fms, Gs^Fms, Gs^Fp, Gs^Fp, Gs^Fp, Ww, Gs^Fp, Ww, Ww, Ww, Gg, Gg^Vh, Gs^Fp, Gs^Fp, Hh, Hh, Gs^Fp, Gs^Fp, Gs^Fp
Xoc, Xoc, Xoc^Efs, Xoc^Efs, Iwr, Iwr, Iwr, Xoc^Efs, Xoc, Mm, Mm, Gg, Gg, Gg, Gg, Ce, Mm, Gg, Gg, Gg, Gg, Gs^Fp, Gg, Gs^Fms, Gg, Gs^Fms, Gg, Gg, Gg, Gs^Fds, Gs^Fds, Gs^Fds, Gs^Fds, Gg, Gg, Gs^Fms, Gs^Fp, Gg, Gg^Vh, Ww, Wo, Wo, Wo, Ww, Ww, Gs^Fp, Gs^Fp, Gs^Fp, Gs^Fp, Gs^Fp, Gs^Fp, Gs^Fp
Xoc, Xoc, Iwr, Iwr, Iwr, Iwr, Xoc, Xoc, Xoc, Mm, Gg, Gg, Rr, Gg, Gg, Gg, Gg, Ch, Gg, Gg, Gg, Gg, Gg, Gs^Fms, Gg, Gg, Gg, Gg, Gg, Gg, Gg, Gg, Gs^Fds, Gg, Gg, Gs^Fms, Gs^Fms, Gs^Fms, Gs^Fms, Ww, Ww, Ww, Ww, Ww, Gs^Fp, Gs^Fp, Gs^Fp, Gs^Fp, Gs^Fp, Gs^Fp, Gs^Fp, Gs^Fp
Xoc, Xoc, Xoc, Iwr, Xoc, Iwr, Iwr, Xoc, Ch, Mm, Gg, Gg, Rr, Gg, Rp^Vhc, Gg, Gg^Vh, Gg, Gg, Ce, Ce, Gg, Gg, Gg, Gg, Gs^Fds, Gg, Gg, Gg, Gg, Gg, Gg, Gs^Fds, Gg, Gg, Gg, Gg, Gg, Gs^Fds, Gs^Fms, Gs^Fms, Gs^Fms, Gs^Fms, Gs^Fp, Gg, Gs^Fp, Gs^Fp, Gs^Fp, Gs^Fp, Gs^Fp, Gs^Fp, Gs^Fp
Mm, Xoc, Xoc, Xoc, Xoc, Xoc, Xoc, Rr, Rr, Gg, Gg, Gg^Ecf, Rr, Gg, Rr, Rr, Rp^Vhc, Gg, Gg^Efm, Gg, Gg, Ce, Gg, Gg, Gg, Gg, Gg, Gg, Gs^Fds, Gs^Fds, Gs^Fds, Gs^Fds, Gg, Gg, Gg, Gg, Gg, Gg, Gg, Gs^Fds, Gs^Fms, Gs^Fms, Gs^Fp, Gs^Fp, Gg, Gs^Fp, Gs^Fp, Gs^Fp, Gs^Fp, Gs^Fp, Gs^Fp, Gs^Fp
Mm, Mm, Mm, Xoc, Mm, Xoc, Gg, Ch, Gg, Rr, Rr, Gg, Rr, Rr, Gg, Gg, Gg, Gg, Gg, Gg, Gg, Gg, Gg, Ch, Gg, Gg, Gg, Gs^Fds, Gg, Gs^Fds, Gs^Fds, Gs^Fds, Gg, Gs^Fds, Gs^Fds, Gs^Fds, Gg, Gs^Fds, Gg, Gg, Gg, Gs^Fms, Gs^Fp, Gs^Fp, Gg, Gs^Fp, Gs^Fp, Gs^Fp, Gs^Fp, Gs^Vl, Gs^Fp, Gs^Fp
Mm, Mm, Mm, Mm, Hh^Vhh, Hh, Hh, Gg, Gg, Gg, Rp^Vhc, Rr, Rr, Gg, Gg, Gg, Gg, Gg^Efm, Gg, Gg^Efm, Gg, Gg, Gg, Gg, Ce, Gg, Gg, Gg, Gs^Fds, Gs^Fds, Gs^Fds, Gs^Fds, Gs^Fds, Gs^Fds, Gg, Gs^Fds, Gg, Gg, Gg, Gs^Fds, Gg, Gs^Fp, Gg, Gg, Gs^Fp, Gs^Fp, Gs^Fp, Gs^Fp, Gs^Fp, Gs^Fp, Gs^Fp, Gs^Fp
Mm, Mm, Mm, Mm, Gs^Fds, Hh, Gg, Gg, Gg, Gg, Gg, Gg, Rr, Rr, Rr, Gg, Rr, Gg, Gg, Gg^Vh, Gg, Gg, Gg, Gg, Gg, Ce, Gg, Gg, Gs^Fds, Gs^Fds, Gs^Fds, Gg, Gg, Gs^Fds, Gs^Fds, Gs^Fds, Gs^Fds, Gg, Gg, Gs^Fms, Gs^Fms, Gs^Fms, Gg, Gs^Fp, Gs^Fp, Gs^Fp, Gs^Fp, Gs^Fp, Gs^Fp, Gs^Fp, Gs^Fp, Gs^Fp
Mm, Mm, Mm, Mm, Gs^Fds, Gs^Fds, Gs^Fds, Gg, Gg, Ch, Ch, Gg, Rr, Rr, Rr, Rr, Gs^Fds, Gs^Fds, Gs^Fds, Gg, Gg, Gg, Gg, Gg, Gg, Ce, Gg, Gg, Gs^Fds, Gs^Fds, Gs^Fds, Gg, Gs^Fds, Gg, Gs^Fds, Gs^Fds, Gs^Fds, Gg, Gg, Gg, Gs^Fms, Gs^Fp, Gs^Fp, Gg, Gs^Fp, Gs^Fp, Gs^Fp, Gs^Fp, Gs^Fp, Gs^Fp, Gs^Fp, Gs^Fp
Mm, Mm, Mm, Hh, Hh, Gg^Vh, Gs^Fds, Gs^Fds, Ch, Ch, 2 Kh, Ch, Rr, Rr, Rr, Gg, Gs^Fds, Gs^Fds, Gs^Fds, Gg, Gg, Gg^Vh, Gg, Gg, Gg, Gg, Gg, Gg, Gg, Gs^Fds, Gg^Vh, Gg, Gs^Fds, Gs^Fds, Gs^Fds, Gs^Fds, Gs^Fds, Gs^Fds, Gg^Vh, Gs^Fms, Gs^Fms, Gs^Fms, Gg, Gg, Gg, Gg, Gs^Fp, Gs^Fp, Gs^Fp, Gs^Fp, Gs^Fp, Gs^Fp
Mm, Mm, Ch, Hh, Gg, Gg, Gg, Gg, Gg, Ch, Ch, Ch, Rr, Rr, Rr, Gg, Gs^Fds, Gs^Fds, Gg, Gg, Re, Gg, Gg, Gg^Efm, Gg, Ch, Gg, Gg, Gg, Gg, Gg, Gg, Gs^Fds, Gs^Fds, Gs^Fms, Gs^Fms, Gs^Fds, Gs^Fds, Gg, Gg, Gg, Gs^Fms, Gg, Gg, Gs^Fp, Gs^Fp, Gg, Gs^Fp, Gs^Fp, Gs^Fp, Gs^Fp, Gs^Fp
Mm, Mm, Hh, Hh, Gg, Gg, Gg^Vh, Gg, Gg, Ch, Gg, Gg, Rr, Rr, Rr, Gg, Gg, Gg, Re, Re, Re, Ce, Gg, Gg, Gg, Gg, Gg, Gg, Gg, Gg, Gg, Gg, Gs^Fds, Gs^Fds, Gs^Fds, Gs^Fms, Gs^Fms, Gs^Fds, Gs^Fms, Gg, Gs^Fp, Gs^Fp, Gg, Gg, Gg, Gs^Fp, Gg, Gg, Gg, Gs^Vh, Gs^Fp, Gs^Fp
Hh, Hh, Ce, Gg, Gg, Gg, Gg, Gg, Gg, Gg, Gg^Vh, Gg, Rr, Rr, Rr, Gg^Efm, Gg, Gg^Efm, Re, Re, Re, Re, Re, Gg^Efm, Gg, Ce, Gg, Gg, Gg, Gg, Gg, Gs^Fds, Gs^Fds, Gs^Fms, Gs^Fms, Gs^Fms, Gg, Gs^Fms, Gs^Fms, Gs^Fms, Gs^Fp, Gg, Gg, Gg, Gg, Gg, Gg, Gg, Gg, Gs^Fp, Gg, Gg
Hh, Hh, Hh, Ce, Hh, Gg, Gg^Fet, Gg^Fet, Gg^Fet, Gg, Gg^Efm, Gg, Rr, Rr, Rr, Rr, Rr, Rr, Gg, Re, Gg, Re, Gg, Gg, Gg, Ce, Gg, Gg, Gg, Gg, Gg, Gs^Fds, Gs^Fms, Gs^Fms, Gs^Fms, Gg, Gs^Fms, Gs^Fms, Gs^Fms, Gs^Fp, Gs^Fp, Gg, Gs^Fp, Gg, Gg, Gg, Gg, Gg, Gs^Fp, Gs^Fp, Gs^Fp, Gs^Fp
Gs^Fp, Gs^Fp, Hh, Hh, Ch, Gg, Gg, Gg^Fet, Gg^Fet, Gg^Efm, Gg^Efm, Gg^Efm, Gg, Rr, Rr, Rr, Rr, Rr, Rr, Gg, Gg^Vh, Gg, Gg^Efm, Gg, Gg, Ce, Gg, Gg, Gg, Gg, Gg, Gs^Fms, Gs^Fp, Gs^Fms, Gs^Fp, Gg^Vh, Gs^Fp, Gs^Fp, Gs^Fp, Gs^Fp, Chr, Gg, Gg, Gg, Gs^Fp, Gs^Fp, Gg, Gs^Fp, Gs^Fp, Gs^Fp, Gs^Fp, Gs^Fp
Gs^Fp, Gs^Fp, Gs^Fp, Hh, Hh, Hh, Gg, Gg^Fet, Gg, Gg, Ww, Ww, Ww, Gg, Gg^Efm, Rr, Rr, Rr, Rr, Rr, Rr, Gg, Gg^Efm, Gg, Ch, Gg, Gg, Gg, Gg, Gg, Gg, Gg, Gg, Gs^Fp, Gg, Gg, Gg, Gg, Gg, Gg, 1 Khr, Gs^Fp, Gs^Fp, Ww, Ww, Gg, Gs^Fp, Gg, Gg, Gs^Fp, Gg, Gg
Gs^Fp, Gs^Fp, Gs^Fp, Hh, Ce, Hh, Hh, Gg, Gg^Vh, Ww, Ww, Ww, Ww, Ww, Gg^Efm, Gg, Gg^Vh, Rr, Rr, Rr, Rr, Rr, Rr, Gg, Ch, Ch^Ecf, Gg, Gg, Gg, Gg, Gg, Gg, Gg, Gg, Gg, Gg, Gg, Gg, Gg, Chr, Chw, Ww, Ww, Ww, Wo, Ww, Gg, Gg, Gg, Gg, Gg, Gg
Gs^Fp, Gs^Fp, Gs^Fp, Hh, Ce, Hh, Hh, Gg, Gg, Ww, Ww, Ww, Ww, Ww, Gg, Gg^Fet, Gg^Fet, Gg^Efm, Gg, Rr, Rr, Rr, Rd, Gg, Gg, Gg, Gg, Gg, Gg, Gg, Gg, Gg, Gg, Gg, Gg, Gg, Gs^Fp, Gg, Gs^Fp, Gg, Gs^Fp, Ww, Ww, Wo, Ww, Ww, Gg^Vh, Gg, Hh, Gg, Gg, Gg
Gs^Fp, Gs^Fp, Gs^Fp, Gs^Fp, Hh, Ce, Hh, Hh, Hh, Gg, Gg, Gg, Gg, Gg, Gg, Gg, Gg, Gg^Efm, Gg, Ch, Ch, Gg, Gg, Rd, Rd, Gg, Gg, Gg, Gg, Gg, Gs^Fms, Gg, Gs^Fms, Gg, Gg, Gg, Gs^Fp, Gs^Fp, Gg, Gs^Fp, Gs^Fp, Ww, Gs^Fp, Ww, Hh, Hh, Hh, Hh, Hh, Hh, Gg, Gg
Gs^Fp, Gs^Fp, Gg, Gs^Fp, Gg, Hh, Hh, Ch, Hh, Ce, Ce, Ce, Gg, Ch, Gg, Ce, Ce, Ce, Gg, Ch^Ecf, Gg, Gg, Gg, Gg, Gg, Rd, Gg, Gg, Gg, Gg^Vh, Gs^Fms, Gs^Fp, Gs^Fp, Gg, Gg, Gg, Gs^Fms, Gg, Gs^Fms, Gs^Fp, Gg, Gg, Gs^Fp, Gs^Fp, Gs^Fp, Gs^Fp, Hh, Hh, Gs^Fp, Hh, Gg, Gg
Gs^Fp, Gs^Fp, Gg, Gg, Gs^Fp, Gg, Gg, Hh, Gg, Hh, Hh, Gg, Gg, Gg, Gg, Gg, Gg, Gg, Gg, Gg, Gg, Gg, Gg, Gg, Gg, Rd, Rd, Gg, Gg, Gg, Gg, Gs^Fms, Gg, Gs^Fms, Gg, Gg, Gs^Fds, Gs^Fms, Gs^Fms, Gs^Fms, Gg, Gg, Gg, Gs^Fp, Gs^Fp, Gs^Fp, Hh, Hh, Hh, Hh, Hh, Hh
Gg, Gg, Gs^Fp, Gg, Gg, Gs^Fp, Gg, Gg, Gg, Gg, Gg, Gg, Gg, Gg, Gg, Gg, Gg, Gg, Gg, Gg, Gg, Gg, Gg, Gg, Gg, Gg, Gg, Rd, Rd, Gg, Gg, Gg, Gg, Gg, Re^Gvs, Re^Gvs, Gs^Fds, Gs^Fds, Gs^Fms, Gs^Fds, Gs^Fms, Gs^Fp, Gs^Fms, Gs^Fp, Gs^Fds, Hh, Hh, Gs^Fp, Hh, Hh, Gg, Gg
Gg, Gg, Gg, Gg, Gg, Gg, Gg, Gg, Re^Gvs, Gg, Re^Gvs, Gg, Gg, Gg, Gg, Gg, Gg, Re^Gvs, Re^Gvs, Re^Gvs, Re^Gvs, Gg, Re^Gvs, Gs^Fds, Gg, Gg, Gg, Gg, Rd, Gg, Gg, Gg, Gg, Gg, Re^Gvs, Re^Gvs, Re^Gvs, Gs^Fds, Gg, Gs^Fms, Gg, Gs^Fds, Gg, Gs^Fms, Gg, Gg, Gg, Gg, Gg, Gg, Gg, Gg
Gg, Gg, Gg, Gg, Gs^Fds, Gg, Gg, Re^Gvs, Re^Gvs, Re^Gvs, Re^Gvs, Re^Gvs, Re^Gvs, Gg, Gg, Gg, Gg, Gg, Re^Gvs, Re^Gvs, Re^Gvs, Re^Gvs, Re^Gvs, Gg, Gg, Gs^Fds, Gg, Gg, Gg, Rd, Gg, Gg, Gg, Gg, Re^Gvs, Re^Gvs, Re^Gvs, Gg^Efm, Re^Gvs, Gg, Gg, Gg, Gg, Gg, Gg, Gg, Gg, Gg, Re^Gvs, Gg, Re^Gvs, Gg
Gg, Gg, Gg, Gg, Gs^Fds, Gs^Fds, Gg, Gg, Gg, Gs^Vh, Gg, Re^Gvs, Gg, Gg, Gg, Gg, Gs^Fds, Gs^Fds, Gs^Vh, Gg, Gg, Re^Gvs, Gg, Gg, Gg, Gg, Gs^Fds, Gg, Gg, Rd, Gg, Gg, Gg, Gg, Gg, Re^Gvs, Re^Gvs, Re^Gvs, Gg, Gg, Gs^Fds, Gg, Gs^Fds, Gg, Gs^Fds, Gg, Gs^Fds, Gg, Re^Gvs, Re^Gvs, Re^Gvs, Re^Gvs
Gg, Gg, Gg, Gg, Gg, Gg, Gg, Gg, Gs^Fds, Gs^Fds, Gs^Fds, Gg, Gg, Gg, Gg, Gg, Gs^Fms, Gs^Fds, Gg, Gg, Gg, Gg, Gg^Efm, Gg, Gg, Gg^Efm, Gg, Gg, Gg, Rd, Gg, Gs^Vh, Gg, Gg, Gg, Gg^Efm, Gg, Gg, Gg, Gg, Gg, Gs^Fds, Gs^Fds, Gs^Fds, Gs^Fds, Gs^Vh, Gs^Fds, Gg, Gg, Re^Gvs, Re^Gvs, Re^Gvs
Gg, Gg, Gg, Gg, Gg, Gg, Gg, Gg, Gs^Fds, Gs^Fds, Gs^Fds, Gg, Gg, Gg, Gg, Gs^Fms, Gs^Fms, Gs^Fms, Gg, Gg, Gg, Gg, Gg, Gg, Gg, Gg, Gg, Gg, Gg, Rd, Gg, Gg, Gg, Gg, Gg, Gg, Gg, Gg, Gg, Gg, Gg, Gs^Fds, Gs^Fds, Gs^Fds, Gs^Fds, Gs^Fds, Gs^Fds, Gs^Fds, Gs^Fds, Gg, Gg, Re^Gvs
